. . . # # . . . . .
# # . . . . # # # .
. . . # # . # . . .
. # . . . . # . # #
. # # # # . . . . .
. . . . # # # # # .
# # # . . . . . # .
. . # # # # # . . .
. . . . . . # # # .
# # # # # . . . . .